..................................................
..................................................
..................................................
..................................................
....▒▒▒▒▒▒▒▒▒▒▒▒▒▒▒▒▒▒▒▒▒▒▒▒▒▒▒▒▒▒▒▒▒▒▒▒▒▒▒▒▒.....
....▒   ▒   ▒             ▒ ▒           ▒   ▒.....
....▒ ▒ ▒ ▒ ▒▒▒ ▒▒▒▒▒▒▒▒▒ ▒ ▒ ▒▒▒ ▒▒▒▒▒ ▒▒▒ ▒.....
....▒ ▒   ▒   ▒   ▒     ▒ ▒ ▒ ▒   ▒         ▒.....
....▒ ▒▒▒▒▒▒▒ ▒▒▒ ▒ ▒▒▒▒▒ ▒ ▒ ▒ ▒▒▒▒▒▒▒▒▒▒▒ ▒.....
....▒ ▒           ▒       ▒ ▒ ▒       ▒   ▒ ▒.....
....▒ ▒▒▒ ▒▒▒▒▒▒▒▒▒ ▒▒▒▒▒▒▒ ▒ ▒▒▒▒▒▒▒ ▒ ▒ ▒ ▒.....
....▒   ▒ ▒       ▒ ▒               ▒ ▒ ▒   ▒.....
....▒▒▒ ▒▒▒ ▒▒▒▒▒ ▒ ▒ ▒▒▒▒▒▒▒▒▒▒▒ ▒▒▒ ▒ ▒▒▒▒▒.....
....▒   ▒   ▒   ▒ ▒ ▒   ▒   ▒     ▒   ▒ ▒   ▒.....
....▒ ▒▒▒ ▒▒▒ ▒ ▒ ▒ ▒▒▒▒▒ ▒ ▒ ▒▒▒▒▒ ▒▒▒ ▒▒▒ ▒.....
....▒   ▒   ▒ ▒ ▒ ▒   ▒   ▒ ▒   ▒   ▒       ▒.....
....▒ ▒ ▒▒▒ ▒▒▒ ▒ ▒▒▒ ▒ ▒▒▒ ▒▒▒▒▒ ▒▒▒▒▒▒▒▒▒▒▒.....
....▒ ▒   ▒ ▒   ▒ ▒   ▒ ▒ ▒       ▒   ▒     ▒.....
....▒▒▒▒▒ ▒ ▒ ▒▒▒ ▒ ▒▒▒ ▒ ▒▒▒ ▒▒▒▒▒ ▒ ▒ ▒▒▒ ▒.....
....▒     ▒ ▒   ▒ ▒     ▒   ▒ ▒   ▒ ▒     ▒ ▒.....
....▒ ▒▒▒▒▒ ▒ ▒ ▒ ▒▒▒▒▒▒▒ ▒ ▒ ▒ ▒ ▒ ▒▒▒▒▒▒▒ ▒.....
....▒ ▒     ▒ ▒ ▒   ▒     ▒   ▒ ▒   ▒       ▒.....
....▒ ▒ ▒▒▒▒▒▒▒ ▒▒▒ ▒▒▒▒▒▒▒▒▒▒▒ ▒▒▒▒▒ ▒▒▒▒▒▒▒.....
....▒ ▒ ▒     ▒   ▒ ▒           ▒   ▒ ▒     ▒.....
....▒ ▒ ▒ ▒ ▒ ▒ ▒ ▒ ▒ ▒▒▒▒▒ ▒▒▒▒▒ ▒▒▒ ▒ ▒▒▒ ▒.....
....▒ ▒ ▒ ▒ ▒   ▒ ▒ ▒ ▒   ▒   ▒     ▒ ▒ ▒   ▒.....
....▒ ▒ ▒▒▒ ▒▒▒▒▒ ▒ ▒ ▒ ▒▒▒▒▒ ▒▒▒▒▒ ▒ ▒ ▒ ▒▒▒.....
....▒ ▒   ▒     ▒ ▒   ▒ ▒   ▒ ▒     ▒ ▒ ▒   ▒.....
....▒ ▒▒▒ ▒ ▒▒▒ ▒▒▒▒▒ ▒ ▒ ▒▒▒ ▒ ▒ ▒▒▒ ▒▒▒▒▒ ▒.....
....▒     ▒ ▒   ▒   ▒ ▒ ▒       ▒ ▒   ▒     ▒.....
....▒ ▒▒▒▒▒ ▒ ▒▒▒ ▒ ▒▒▒ ▒▒▒▒▒▒▒▒▒▒▒ ▒▒▒ ▒▒▒▒▒.....
....▒   ▒   ▒   ▒ ▒     ▒           ▒       ▒.....
....▒▒▒ ▒▒▒ ▒▒▒ ▒ ▒▒▒▒▒▒▒ ▒▒▒▒▒▒▒▒▒▒▒ ▒▒▒▒▒ ▒.....
....▒ ▒   ▒ ▒   ▒         ▒   ▒     ▒ ▒     ▒.....
....▒ ▒▒▒ ▒▒▒ ▒ ▒▒▒▒▒▒▒▒▒▒▒ ▒▒▒ ▒ ▒▒▒ ▒ ▒▒▒ ▒.....
....▒ ▒   ▒   ▒ ▒   ▒     ▒ ▒   ▒     ▒ ▒   ▒.....
....▒ ▒ ▒▒▒ ▒▒▒ ▒ ▒ ▒ ▒▒▒ ▒ ▒ ▒▒▒▒▒▒▒▒▒ ▒ ▒▒▒.....
....▒   ▒   ▒ ▒   ▒ ▒ ▒   ▒ ▒ ▒      .▒ ▒   ▒.....
....▒ ▒▒▒ ▒▒▒ ▒▒▒▒▒ ▒ ▒ ▒▒▒ ▒ ▒▒▒ ▒ ▒▒▒ ▒▒▒ ▒.....
....▒ ▒   ▒       ▒   ▒ ▒         ▒ ▒   ▒ ▒ ▒.....
....▒ ▒▒▒ ▒ ▒▒▒ ▒▒▒▒▒▒▒ ▒▒▒▒▒▒▒▒▒ ▒▒▒ ▒▒▒ ▒ ▒.....
....▒ ▒   ▒ ▒ ▒       ▒   ▒     ▒ ▒   ▒     ▒.....
....▒ ▒ ▒▒▒ ▒ ▒▒▒▒▒▒▒ ▒▒▒ ▒ ▒▒▒ ▒▒▒ ▒▒▒ ▒▒▒▒▒.....
....▒   ▒           ▒       ▒       ▒       ▒.....
....▒▒▒▒▒▒▒▒▒▒▒▒▒▒▒▒▒▒▒▒▒▒▒▒▒▒▒▒▒▒▒▒▒▒▒▒▒▒▒▒▒.....
..................................................
..................................................
..................................................
..................................................
..................................................
